Acine	CTACATCTAATCATTACTATAACA
dhfR	CATTCAATACACAAATACTCAAAT
Ecoli	TATATAATTCCTCATACCACATAA
folP	ATTATTATCATTCCTATCTAACCA
gcp	TTCACTTATCTACTATTTCTTAAC
gyrA	CTACACTATATATTCTACACAATT
Klebs	TCAATTACACTCTATAATACCTTA
leuS	AATTCAACTACTCTCAATTTACTA
lolA	TCTATAACTCCACTTAATAACATA
lolB	TTAATCTCAATATACCTTACCAAC
lppL	TAATACATAACTACTAACTCTAAC
lpxC	ACATAATTCTACTCTAACTCATTT
mexA_V1	TAATTATACATCTCATCTTCTACA
mexA_V2	TCACTAATTAATCACCTACATATT
mreC	TTATTACACTCTATACTCTAATTC
murA	TTACCTTAACTATATTCTACAACA
omlA	TCATATACTACTCTTTAAACACTA
opr86	CAACTACACTTATCATTACATAAA
oprL	ATTTACACTACTTACACACAATAA
ostA	CTTCTATCTATCTTTCATTTCTAT
P57920	TCTTTCAAACAATACTTCTCTAAA
PA14_V1	CTACTATACATCTTACTATACTTT
PA14_V2	ATATCTATCATCCTACTACATATA
PAO1	TCTAACATACACTCATAATAATAC
PCR_BC3	ACATATCCAACCTTATATAACATT
PCR_BC45	ATTAATTCCACTTACCTTACAATA
PCR_BC53	TACTTAAACATACAAACTTACTCA
Staph	AACCTATTATTCTCTACCTATAAT
tolB	AACTTAATCTCTTATAACTACCTT